// 0 - Empty spot
// 1 - Weak brick
// 2 - Strong brick
0000000000
0022222200
0020000200
0020000200
0020110200
0020110200
0020110200
0020000200
0020000200
0022222200