// 0 - Empty spot
// 1 - Weak brick
// 2 - Strong brick
0111111110
0011221100
2001221002
2100110012
2110000112
2100110012
2001221002
0011221100
0111111110
